##################
# $$$$$$$$$$$$$$ #
#                #
#                #
#                #
#                #
#                #
#                #
# @@@@@@@@@@@@@@ #
##################
